{
    "default": 0,
    "map": {
        "F": {
            "163": 1,
            "164": 1,
            "165": 1,
            "166": 1,
            "167": 1,
            "168": 1,
            "169": 1,
            "170": 1,
            "171": 1,
            "172": 1,
            "173": 1,
            "174": 1,
            "175": 1,
            "176": 1,
            "177": 1,
            "178": 1,
            "179": 1,
            "180": 1,
            "181": 1
        }
    },
    "name": "epi_05"
}