{
    "default": 0,
    "map": {
        "F": {
            "254": 1,
            "255": 1,
            "256": 1,
            "257": 1,
            "258": 1,
            "259": 1,
            "260": 1,
            "261": 1,
            "262": 1,
            "263": 1,
            "264": 1,
            "265": 1,
            "266": 1,
            "267": 1,
            "268": 1,
            "269": 1,
            "270": 1,
            "271": 1,
            "272": 1,
            "273": 1,
            "274": 1,
            "275": 1,
            "276": 1,
            "277": 1
        }
    },
    "name": "epi_02"
}