{
    "default": 0,
    "map": {
        "F": {
            "422": 1,
            "423": 1,
            "424": 1,
            "425": 1,
            "426": 1,
            "427": 1,
            "428": 1,
            "429": 1,
            "430": 1,
            "431": 1,
            "432": 1,
            "433": 1,
            "434": 1,
            "435": 1,
            "436": 1
        }
    },
    "name": "epi_04"
}