{
    "default": 0,
    "map": {
        "F": {
            "62": 1,
            "63": 1,
            "64": 1,
            "65": 1,
            "66": 1,
            "67": 1,
            "68": 1,
            "69": 1,
            "196": 1,
            "197": 1,
            "198": 1,
            "199": 1,
            "200": 1,
            "201": 1,
            "202": 1,
            "203": 1,
            "204": 1,
            "205": 1,
            "206": 1,
            "207": 1,
            "208": 1,
            "209": 1,
            "210": 1,
            "31": 1,
            "378": 1,
            "344": 1,
            "380": 1,
            "254": 1,
            "255": 1,
            "256": 1,
            "257": 1,
            "258": 1,
            "259": 1,
            "260": 1,
            "261": 1,
            "262": 1,
            "263": 1,
            "264": 1,
            "265": 1,
            "266": 1,
            "267": 1,
            "268": 1,
            "269": 1,
            "270": 1,
            "271": 1,
            "272": 1,
            "273": 1,
            "274": 1,
            "275": 1,
            "276": 1,
            "277": 1,
            "44": 1,
            "45": 1,
            "46": 1,
            "47": 1,
            "48": 1,
            "49": 1,
            "50": 1,
            "305": 1,
            "306": 1,
            "307": 1,
            "308": 1,
            "309": 1,
            "310": 1,
            "422": 1,
            "423": 1,
            "424": 1,
            "425": 1,
            "426": 1,
            "427": 1,
            "428": 1,
            "429": 1,
            "430": 1,
            "431": 1,
            "432": 1,
            "433": 1,
            "434": 1,
            "435": 1,
            "436": 1,
            "163": 1,
            "164": 1,
            "165": 1,
            "166": 1,
            "167": 1,
            "168": 1,
            "169": 1,
            "170": 1,
            "171": 1,
            "172": 1,
            "173": 1,
            "174": 1,
            "175": 1,
            "176": 1,
            "177": 1,
            "178": 1,
            "179": 1,
            "180": 1,
            "181": 1
        }
    },
    "name": "epi_00"
}