{
    "default": 0,
    "map": {
        "F": {
            "26": 1,
            "27": 1,
            "28": 1,
            "29": 1,
            "30": 1,
            "31": 1,
            "32": 1,
            "33": 1,
            "34": 1,
            "35": 1,
            "36": 1,
            "37": 1,
            "38": 1,
            "39": 1,
            "40": 1,
            "41": 1,
            "42": 1,
            "43": 1,
            "44": 1,
            "45": 1,
            "46": 1,
            "47": 1,
            "48": 1,
            "53": 1,
            "54": 1,
            "55": 1,
            "56": 1,
            "57": 1,
            "58": 1,
            "59": 1,
            "60": 1,
            "61": 1,
            "62": 1,
            "63": 1,
            "64": 1,
            "65": 1,
            "66": 1,
            "67": 1,
            "68": 1,
            "69": 1,
            "70": 1,
            "71": 1,
            "72": 1,
            "73": 1,
            "74": 1,
            "75": 1,
            "76": 1,
            "77": 1,
            "78": 1,
            "79": 1,
            "80": 1,
            "81": 1,
            "83": 1,
            "84": 1,
            "87": 1,
            "90": 1,
            "91": 1,
            "94": 1,
            "95": 1,
            "96": 1,
            "97": 1,
            "98": 1,
            "147": 1,
            "148": 1,
            "149": 1,
            "150": 1,
            "151": 1,
            "152": 1,
            "153": 1,
            "154": 1,
            "155": 1,
            "156": 1,
            "157": 1,
            "158": 1,
            "159": 1,
            "160": 1,
            "161": 1,
            "162": 1,
            "163": 1,
            "164": 1,
            "165": 1,
            "166": 1,
            "167": 1,
            "168": 1,
            "169": 1,
            "170": 1,
            "171": 1,
            "172": 1,
            "173": 1,
            "174": 1,
            "175": 1,
            "176": 1,
            "177": 1,
            "178": 1,
            "179": 1,
            "180": 1,
            "181": 1,
            "182": 1,
            "183": 1,
            "184": 1,
            "185": 1,
            "186": 1,
            "187": 1,
            "188": 1,
            "189": 1,
            "190": 1,
            "191": 1,
            "192": 1,
            "193": 1,
            "194": 1,
            "195": 1,
            "196": 1,
            "197": 1,
            "198": 1,
            "199": 1,
            "200": 1,
            "201": 1,
            "202": 1,
            "203": 1,
            "204": 1,
            "205": 1,
            "206": 1,
            "207": 1,
            "208": 1,
            "209": 1,
            "210": 1,
            "211": 1,
            "212": 1,
            "213": 1,
            "214": 1,
            "215": 1,
            "216": 1,
            "217": 1,
            "218": 1,
            "219": 1,
            "222": 1,
            "226": 1,
            "227": 1,
            "230": 1,
            "233": 1,
            "237": 1,
            "241": 1,
            "242": 1,
            "247": 1,
            "248": 1,
            "251": 1,
            "252": 1,
            "254": 1,
            "255": 1,
            "256": 1,
            "257": 1,
            "258": 1,
            "259": 1,
            "260": 1,
            "261": 1,
            "262": 1,
            "263": 1,
            "264": 1,
            "265": 1,
            "266": 1,
            "267": 1,
            "268": 1,
            "269": 1,
            "270": 1,
            "271": 1,
            "272": 1,
            "273": 1,
            "274": 1,
            "275": 1,
            "276": 1,
            "277": 1,
            "278": 1,
            "281": 1,
            "282": 1,
            "287": 1,
            "288": 1,
            "289": 1,
            "290": 1,
            "291": 1,
            "292": 1,
            "293": 1,
            "294": 1,
            "295": 1,
            "296": 1,
            "297": 1,
            "298": 1,
            "299": 1,
            "300": 1,
            "301": 1,
            "302": 1,
            "303": 1,
            "304": 1,
            "305": 1,
            "306": 1,
            "307": 1,
            "308": 1,
            "309": 1,
            "310": 1,
            "311": 1,
            "312": 1,
            "313": 1,
            "314": 1,
            "321": 1,
            "322": 1,
            "333": 1,
            "334": 1,
            "335": 1,
            "336": 1,
            "342": 1,
            "343": 1,
            "344": 1,
            "346": 1,
            "347": 1,
            "348": 1,
            "349": 1,
            "360": 1,
            "361": 1,
            "362": 1,
            "363": 1,
            "364": 1,
            "365": 1,
            "366": 1,
            "367": 1,
            "375": 1,
            "376": 1,
            "377": 1,
            "378": 1,
            "379": 1,
            "380": 1,
            "381": 1,
            "382": 1,
            "383": 1,
            "384": 1,
            "385": 1,
            "386": 1,
            "387": 1,
            "388": 1,
            "389": 1,
            "390": 1,
            "391": 1,
            "392": 1,
            "393": 1,
            "394": 1,
            "395": 1,
            "396": 1,
            "397": 1,
            "398": 1,
            "399": 1,
            "400": 1,
            "401": 1,
            "402": 1,
            "403": 1,
            "412": 1,
            "413": 1,
            "414": 1,
            "415": 1,
            "416": 1,
            "417": 1,
            "418": 1,
            "419": 1,
            "420": 1,
            "421": 1,
            "422": 1,
            "423": 1,
            "424": 1,
            "425": 1,
            "426": 1,
            "427": 1,
            "428": 1,
            "429": 1,
            "430": 1,
            "431": 1,
            "432": 1,
            "433": 1,
            "434": 1,
            "435": 1,
            "436": 1,
            "437": 1,
            "438": 1,
            "439": 1,
            "440": 1,
            "441": 1,
            "442": 1,
            "443": 1,
            "445": 1,
            "446": 1,
            "447": 1,
            "448": 1,
            "449": 1,
            "450": 1,
            "451": 1,
            "452": 1,
            "453": 1,
            "454": 1,
            "455": 1,
            "456": 1,
            "462": 1,
            "463": 1,
            "464": 1,
            "465": 1,
            "466": 1,
            "467": 1,
            "468": 1,
            "469": 1,
            "470": 1,
            "471": 1,
            "472": 1,
            "473": 1,
            "474": 1,
            "475": 1,
            "476": 1,
            "477": 1,
            "478": 1,
            "479": 1,
            "480": 1,
            "481": 1,
            "482": 1,
            "483": 1,
            "484": 1,
            "485": 1,
            "486": 1,
            "487": 1,
            "488": 1,
            "489": 1,
            "490": 1,
            "491": 1,
            "492": 1,
            "493": 1,
            "494": 1,
            "495": 1,
            "496": 1,
            "497": 1,
            "498": 1,
            "499": 1,
            "500": 1,
            "501": 1,
            "502": 1,
            "503": 1,
            "504": 1,
            "505": 1,
            "506": 1,
            "507": 1,
            "508": 1,
            "509": 1,
            "510": 1,
            "511": 1,
            "512": 1,
            "513": 1,
            "514": 1
        }
    },
    "name": "surface_residues_postf"
}